R 800 600
NO  ./textures/NO.xpm
SO ./textures/SO.xpm
WE ./textures/WE.xpm
EA ./textures/EA.xpm
S ./textures/WE.xpm

F 0,0,0
C 0,0,0

111111111
100000001
100000001
100000001
100000001
100000001
100000001
111111111
