R 800 600
NO ./textures/WALL68.xpm
SO ./textures/WALL68.xpm
WE ./textures/WALL68.xpm        
EA ./textures/WALL68.xpm
S ./textures/barrel.xpm
F 125,200,124
C 173,200,230

        1111111111111111111111111
        1000000000110111100000001
        10110000011101  1020E0001
        1001000000000111100000001
11111111101100010011100000000011
100000000011000001110111111111111
11110111111111011100000010001
11110111111111011101010010001
11000000110101011100000010001
10002000000000001100000010001
10000000000000001101010010001
11000001110101011111011110001
11110111 11101011101111010001
11111111 1111111 111111111111