R 800 600   
NO ./textures/WALL68.xpm
SO ./textures/WALL68.xpm
WE ./textures/WALL68.xpm
EA ./textures/WALL68.xpm
S ./textures/barrel.xpm
F 125, 200, 124
C 173, 216, 230

111111111111111
10020000200000111111111111111111111111111111111111111111111
100200000020000W01
10000000111111111111111111111111111111111111111111111111111
100222222220201
100010001111111
100010001
100010001
100000001
100200001
100000001
100000001
100000001
100000001
111111111
