R 800 600
NO  ./textures/NO.xpm
SO ./textures/SO.xpm
WE ./textures/WE.xpm
EA ./textures/EA.xpm
S ./textures/WE.xpm

F 25,100,24
C 25,24,100

111111111111111
100000000000001
100000000000001
100000001111111
100000001
100000001
100000001
100000001
100000001
100000001
100000001
100000001
1000N0001
100000001
111111111
