R 480 320
NO  ./textures/NO.xpm
SO ./textures/SO.xpm
WE ./textures/WE.xpm
EA ./textures/EA.xpm
S ./textures/WE.xpm

F 125,100,124
C 225,214,100

111111111111111
100000000000001
100000000000001
100000001111111
100000000000001
100010001111111
100010001
100010001
100000001
100000001
100000001
100000001
1000N0001
100000001
111111111
