WE ./textures/WALL68.xpm      
EA ./textures/WALL68.xpm
S ./textures/barrel.xpm
F 125,255,123
C 123,34,123
NO ./textures/WALL68.xpm sdsd
SO ./textures/WALL16.xpm      
R  800 600






1111111111111111111111
10000000000000000000001
10111111111111111111101
101                 101
101                  1
101                 101
101                 101
101                 101
101       111       101
101       121       101
101       121       101
101       121       101
10111111111011111111101
10000000000N00000000001
11111111111111111111111




