R 800 600
NO  ./textures/WALL68.xpm
SO ./textures/WALL68.xpm
WE ./textures/WALL68.xpm
EA ./textures/WALL68.xpm
S ./textures/WALL68.xpm

F 125, 200, 124
C 173, 216, 230

111111111111111
100000000000001
100000000000001
1000N0001111111
100000000000001
100010001111111
100010001
100010001
100000001
100000001
100000001
100000001
100000001
100000001
111111111
