R 800 600
NO ./textures/WALL68.xpm
SO ./textures/WALL16.xpm
WE ./textures/WALL68.xpm        
EA ./textures/WALL68.xpm
S ./textures/barrel.xpm
F 125,200,124
C 173,200,230

        1111111111111111111111111
        1200000000000000000000021
        1000000000000000000000001
        1000000000000000000000001
        1000000000001000000000001
        1000000000000000000000001
        100000000000N000000000001
        1000000000000000000000001
        1000000000000000000000001
        1000000000000000000000001
        1000000000000000000000001
        1000000000000000000000001
        1200000000000000000000021
11111111111111111111111111111111