

WE ./textures/WALL68.xpm jkljlk        
EA ./textures/WALL68.xpm
S ./textures/barrel.xpm
F 125,200,124

C 173,200,230

NO ./textures/WALL68.xpm
SO ./textures/WALL16.xpm      


R      800 600






1111111111111111111111
10000000000000000000001
10111111111111111111101
101                 101
101                  1
101                 101
101                 101
101                 101
101       111       101
101       121       101
101       121       101
101       121       101
10111111111011111111101
100000000000W0000000001
11111111111111111111111





