R 800 600
NO ./textures/NO.xp
SO ./textures/SO.xpm
WE ./textures/WE.xpm
EA ./textures/EA.xpm
S ./textures/WE.xpm


F 220,100,0
C 2,2,2

1111111111111111111111111
1000000000110000000000001
1000000000110000002000001
1000000000000000000000001
1010111110110000011100001
100000000011000001110111111111111
11110111111111011100000010001
11110111111111011101010010001
11000000110101011100000010001
100020000000000011000N0010001
10000000000000001101010010001
110000011101010111110111100111
1111011111101011101111010001 
111111111111111111111111111111111111111