WE ./textures/WALL68.xpm      
EA ./textures/WALL68.xpm  
S ./textures/barrel.xpm
F 105,205,123
C 128, 166, 255
NO ./textures/WALL68.xpm
SO ./textures/WALL68.xpm      
R  800 600

11111111111111111111111
10000000000000000000001
10111111111111111111101
101                 101
101                 111
101                 101
101                 101
101                 101
101       111       101
101       121       101
101       121       101
101       121       101
10111111111011111111101
10000000000N00000000001
11111111111111111111111
